Entité administrative;Nombre d'indépendants;Hommes;Femmes;15-24 ans;25-49 ans;50-64 ans;65 ans et plus;Moins de 30 ans;55 ans et +;Indépendants (aidants non compris);Aidants;Actifs à titre principal;Actifs à titre complémentaire;Actifs après la pension;Annee
Nivelles;46639;30421;16218;1010;24488;16532;4609;3969;14495;45006;1633;31744;10003;4892;2016
Ath;7773;4852;2921;218;4235;2588;732;702;2264;7171;602;5076;1941;756;2016
Charleroi;26306;16945;9361;866;14967;8160;2313;3070;7260;24767;1539;16751;7074;2481;2016
Mons;16176;9905;6271;411;9310;5016;1439;1708;4511;15183;993;10131;4509;1536;2016
Mouscron;4521;2790;1731;127;2489;1485;420;406;1289;4067;454;3192;894;435;2016
Soignies;14013;8977;5036;356;7970;4520;1167;1405;3788;13093;920;8943;3816;1254;2016
Thuin;12562;7885;4677;378;6752;4249;1183;1286;3758;11721;841;8017;3290;1255;2016
Tournai;11720;7522;4198;275;6352;4001;1092;1067;3504;10736;984;7769;2809;1142;2016
Huy;10045;6427;3618;206;5479;3466;894;981;2964;9500;545;6174;2898;973;2016
Liège;43827;27907;15920;1195;24213;13988;4431;4813;12978;41638;2189;27533;11533;4761;2016
Verviers;24755;16335;8420;697;12689;8672;2697;2508;7897;23064;1691;16104;5707;2944;2016
Waremme;7418;4695;2723;179;4131;2431;677;653;2179;7019;399;4519;2161;738;2016
Arlon;2575;1506;1069;88;1320;912;255;284;828;2360;215;1876;427;272;2016
Bastogne;4574;2995;1579;134;2170;1709;561;436;1602;4233;341;2943;1049;582;2016
Marche-en-Famenne;5802;3889;1913;160;2903;2159;580;574;1924;5385;417;3662;1519;621;2016
Neufchâteau;6438;4298;2140;200;3249;2213;776;647;2169;5985;453;3889;1756;793;2016
Virton;3457;2151;1306;107;1654;1270;426;323;1221;3247;210;2218;793;446;2016
Dinant;10939;7107;3832;286;5728;3850;1075;1086;3426;10179;760;6849;2933;1157;2016
Namur;27614;17540;10074;742;15452;8883;2537;2821;7790;26188;1426;16978;7909;2727;2016
Philippeville;5913;3746;2167;195;3091;2046;581;613;1799;5516;397;3725;1557;631;2016
Nivelles;45240;29664;15576;1016;23943;15916;4365;3827;13763;43599;1641;31162;9465;4613;2015
Ath;7597;4758;2839;202;4193;2497;705;708;2173;6983;614;5037;1844;716;2015
Charleroi;25926;16717;9209;847;14700;8136;2243;3021;7087;24406;1520;16680;6854;2392;2015
Mons;15872;9777;6095;440;9108;4951;1373;1704;4411;14895;977;10088;4331;1453;2015
Mouscron;4510;2792;1718;125;2518;1456;411;432;1264;4025;485;3228;857;425;2015
Soignies;13652;8792;4860;384;7857;4315;1096;1361;3611;12749;903;8782;3700;1170;2015
Thuin;12281;7714;4567;361;6613;4208;1099;1225;3618;11416;865;7986;3136;1159;2015
Tournai;11629;7483;4146;297;6370;3921;1041;1102;3384;10610;1019;7849;2679;1101;2015
Huy;9809;6311;3498;254;5395;3337;823;962;2775;9245;564;6115;2795;899;2015
Liège;42966;27561;15405;1251;23688;13862;4165;4738;12602;40763;2203;27227;11237;4502;2015
Verviers;24518;16240;8278;721;12748;8490;2559;2495;7590;22802;1716;16139;5615;2764;2015
Waremme;7236;4609;2627;170;4066;2376;624;622;2107;6808;428;4512;2047;677;2015
Arlon;2561;1492;1069;85;1320;900;256;291;809;2354;207;1840;447;274;2015
Bastogne;4556;3008;1548;136;2209;1668;543;444;1530;4192;364;2968;1029;559;2015
Marche-en-Famenne;5752;3841;1911;164;2887;2148;553;556;1867;5323;429;3670;1487;595;2015
Neufchâteau;6382;4301;2081;197;3217;2230;738;643;2110;5910;472;3926;1709;747;2015
Virton;3425;2149;1276;102;1626;1277;420;325;1217;3205;220;2216;764;445;2015
Dinant;10801;7058;3743;298;5694;3791;1018;1090;3320;10030;771;6855;2857;1089;2015
Namur;26947;17224;9723;715;15234;8577;2421;2757;7431;25503;1444;16802;7564;2581;2015
Philippeville;5802;3701;2101;186;3082;1987;547;575;1707;5423;379;3716;1495;591;2015
Nivelles;44151;29092;15059;1035;23517;15423;4176;3658;13168;42526;1625;30521;9242;4388;2014
Ath;7373;4658;2715;176;4116;2407;674;645;2112;6769;604;4935;1746;692;2014
Charleroi;25603;16591;9012;872;14511;8034;2186;2966;6933;24104;1499;16602;6693;2308;2014
Mons;15600;9699;5901;430;8963;4875;1332;1620;4325;14635;965;10001;4213;1386;2014
Mouscron;4520;2779;1741;125;2549;1444;402;403;1229;4023;497;3270;843;407;2014
Soignies;13460;8612;4848;430;7766;4215;1049;1434;3530;12553;907;8728;3637;1095;2014
Thuin;12065;7600;4465;340;6575;4078;1072;1143;3498;11221;844;7862;3066;1137;2014
Tournai;11492;7389;4103;294;6351;3853;994;1061;3291;10460;1032;7823;2622;1047;2014
Huy;9554;6154;3400;262;5301;3246;745;924;2632;8981;573;6013;2733;808;2014
Liège;42228;27218;15010;1282;23375;13602;3969;4569;12251;39966;2262;26935;11016;4277;2014
Verviers;24330;16217;8113;765;12692;8426;2447;2456;7408;22626;1704;16130;5555;2645;2014
Waremme;6992;4504;2488;168;3930;2307;587;590;1999;6582;410;4377;1980;635;2014
Arlon;2582;1520;1062;95;1330;896;261;273;809;2354;228;1840;473;269;2014
Bastogne;4546;3026;1520;138;2220;1645;543;441;1523;4182;364;2927;1063;556;2014
Marche-en-Famenne;5752;3867;1885;156;2912;2123;561;537;1818;5323;429;3668;1500;584;2014
Neufchâteau;6381;4302;2079;207;3189;2268;717;624;2103;5916;465;3925;1723;733;2014
Virton;3422;2160;1262;98;1647;1275;402;317;1202;3204;218;2227;766;429;2014
Dinant;10519;6925;3594;309;5595;3640;975;1033;3154;9762;757;6784;2707;1028;2014
Namur;26342;17001;9341;746;14945;8396;2255;2672;7106;24919;1423;16591;7340;2411;2014
Philippeville;5737;3678;2059;173;3080;1969;515;543;1656;5373;364;3720;1474;543;2014
Nivelles;43336;28653;14683;972;23247;15142;3975;3447;12815;41710;1626;30196;9040;4100;2013
Ath;7286;4660;2626;145;4107;2392;642;573;2072;6704;582;4934;1709;643;2013
Charleroi;25434;16518;8916;876;14417;8025;2116;2858;6908;23939;1495;16591;6660;2183;2013
Mons;15390;9594;5796;387;8855;4863;1285;1500;4270;14428;962;9953;4134;1303;2013
Mouscron;4471;2771;1700;126;2525;1428;392;383;1208;3980;491;3254;831;386;2013
Soignies;13222;8522;4700;408;7686;4127;1001;1363;3440;12329;893;8642;3565;1015;2013
Thuin;11895;7519;4376;324;6493;4062;1016;1081;3363;11046;849;7844;3004;1047;2013
Tournai;11352;7338;4014;282;6251;3836;983;963;3238;10301;1051;7781;2580;991;2013
Huy;9385;6090;3295;254;5222;3207;702;864;2599;8799;586;6013;2633;739;2013
Liège;41469;26915;14554;1159;23119;13411;3780;4253;11859;39295;2174;26570;10890;4009;2013
Verviers;24143;16178;7965;712;12766;8312;2353;2358;7203;22375;1768;16077;5578;2488;2013
Waremme;6876;4415;2461;169;3858;2273;576;606;1955;6454;422;4343;1928;605;2013
Arlon;2618;1554;1064;90;1369;917;242;276;790;2400;218;1876;502;240;2013
Bastogne;4585;3091;1494;138;2259;1649;539;426;1538;4207;378;2976;1074;535;2013
Marche-en-Famenne;5735;3864;1871;168;2965;2058;544;553;1755;5318;417;3697;1490;548;2013
Neufchâteau;6323;4291;2032;201;3230;2186;706;610;2052;5860;463;3914;1706;703;2013
Virton;3451;2197;1254;94;1681;1283;393;310;1179;3240;211;2265;779;407;2013
Dinant;10404;6892;3512;293;5598;3596;917;998;3050;9617;787;6779;2660;965;2013
Namur;25821;16753;9068;686;14747;8275;2113;2516;6981;24405;1416;16408;7178;2235;2013
Philippeville;5675;3684;1991;159;3087;1938;491;520;1623;5305;370;3672;1491;512;2013
Nivelles;42482;28134;14348;975;23128;14716;3663;3346;12204;40819;1663;29920;8781;3781;2012
Ath;7149;4584;2565;153;4052;2350;594;542;1999;6538;611;4887;1661;601;2012
Charleroi;24979;16262;8717;820;14259;7909;1991;2702;6668;23476;1503;16486;6490;2003;2012
Mons;15214;9560;5654;377;8820;4842;1175;1472;4159;14234;980;10013;4014;1187;2012
Mouscron;4457;2781;1676;123;2570;1399;365;376;1191;3954;503;3295;794;368;2012
Soignies;12939;8359;4580;382;7578;4029;950;1289;3345;12035;904;8538;3439;962;2012
Thuin;11847;7542;4305;332;6576;4001;938;1084;3247;10967;880;7970;2925;952;2012
Tournai;11188;7250;3938;262;6248;3742;936;906;3156;10116;1072;7754;2515;919;2012
Huy;9236;6048;3188;224;5223;3137;652;805;2537;8644;592;6014;2529;693;2012
Liège;40905;26745;14160;1118;22993;13221;3573;4071;11516;38720;2185;26594;10569;3742;2012
Verviers;23869;16079;7790;731;12777;8126;2235;2281;6941;22086;1783;16135;5381;2353;2012
Waremme;6730;4374;2356;155;3775;2264;536;576;1919;6299;431;4285;1878;567;2012
Arlon;2686;1603;1083;80;1430;945;231;291;796;2456;230;1932;525;229;2012
Bastogne;4654;3118;1536;134;2370;1624;526;432;1528;4263;391;3046;1086;522;2012
Marche-en-Famenne;5708;3883;1825;156;2997;2032;523;522;1713;5261;447;3727;1463;518;2012
Neufchâteau;6355;4318;2037;173;3316;2188;678;604;2022;5881;474;3961;1718;676;2012
Virton;3436;2194;1242;92;1718;1262;364;288;1136;3220;216;2283;788;365;2012
Dinant;10261;6841;3420;295;5600;3499;867;1005;2934;9438;823;6809;2541;911;2012
Namur;25454;16604;8850;723;14630;8094;2007;2496;6684;23969;1485;16375;6990;2089;2012
Philippeville;5643;3661;1982;153;3114;1933;443;526;1585;5255;388;3703;1479;461;2012
Nivelles;41380;27578;13802;865;22869;14249;3397;3171;11723;39738;1642;29482;8420;3478;2011
Ath;7011;4517;2494;126;4070;2265;550;541;1904;6383;628;4853;1614;544;2011
Charleroi;24530;16010;8520;802;14044;7803;1881;2594;6486;23056;1474;16327;6314;1889;2011
Mons;14812;9361;5451;353;8591;4798;1070;1403;4032;13812;1000;9911;3813;1088;2011
Mouscron;4449;2777;1672;134;2586;1380;349;420;1168;3925;524;3342;751;356;2011
Soignies;12597;8163;4434;348;7408;3914;927;1230;3241;11673;924;8405;3260;932;2011
Thuin;11588;7407;4181;277;6503;3915;893;1017;3208;10716;872;7951;2749;888;2011
Tournai;11116;7200;3916;235;6233;3785;863;884;3152;9999;1117;7835;2429;852;2011
Huy;9016;5973;3043;249;5107;3033;627;807;2436;8404;612;5917;2441;658;2011
Liège;40111;26351;13760;1047;22670;13106;3288;3979;11156;37882;2229;26549;10138;3424;2011
Verviers;23605;15954;7651;682;12856;7940;2127;2163;6743;21787;1818;16096;5277;2232;2011
Waremme;6508;4245;2263;143;3699;2164;502;537;1817;6062;446;4243;1746;519;2011
Arlon;2739;1636;1103;83;1496;926;234;305;785;2509;230;1950;559;230;2011
Bastogne;4682;3141;1541;134;2417;1613;518;420;1483;4281;401;3092;1072;518;2011
Marche-en-Famenne;5629;3821;1808;149;2982;2001;497;490;1653;5137;492;3707;1428;494;2011
Neufchâteau;6298;4311;1987;173;3343;2150;632;594;1926;5805;493;3960;1695;643;2011
Virton;3439;2209;1230;76;1768;1264;331;264;1122;3216;223;2317;787;335;2011
Dinant;10010;6700;3310;287;5577;3346;800;942;2827;9189;821;6760;2413;837;2011
Namur;24932;16363;8569;686;14523;7899;1824;2397;6489;23436;1496;16232;6802;1898;2011
Philippeville;5532;3590;1942;147;3096;1875;414;480;1534;5126;406;3687;1425;420;2011
Nivelles;40332;27016;13316;807;22553;13877;3095;3042;11217;38658;1674;29031;8128;3173;2010
Ath;6914;4431;2483;143;4020;2243;508;551;1855;6274;640;4854;1555;505;2010
Charleroi;23993;15711;8282;756;13786;7731;1720;2445;6361;22551;1442;16198;6051;1744;2010
Mons;14692;9307;5385;368;8529;4825;970;1407;3922;13655;1037;9961;3758;973;2010
Mouscron;4480;2779;1701;130;2653;1359;338;430;1141;3938;542;3408;733;339;2010
Soignies;12424;8083;4341;337;7344;3890;853;1142;3177;11479;945;8413;3148;863;2010
Thuin;11385;7347;4038;266;6435;3863;821;995;3143;10501;884;7909;2653;823;2010
Tournai;11120;7215;3905;258;6304;3752;806;906;3092;9949;1171;8001;2318;801;2010
Huy;8791;5846;2945;234;5064;2932;561;771;2319;8177;614;5909;2287;595;2010
Liège;39445;26009;13436;1034;22412;12946;3053;3908;10773;37209;2236;26510;9714;3221;2010
Verviers;23354;15830;7524;626;12945;7798;1985;2135;6575;21542;1812;16035;5229;2090;2010
Waremme;6363;4219;2144;145;3622;2145;451;524;1769;5923;440;4279;1609;475;2010
Arlon;2734;1638;1096;99;1504;915;216;312;751;2498;236;1952;566;216;2010
Bastogne;4722;3169;1553;139;2510;1566;507;430;1443;4288;434;3104;1112;506;2010
Marche-en-Famenne;5621;3815;1806;159;3037;1932;493;522;1592;5124;497;3769;1366;486;2010
Neufchâteau;6329;4363;1966;167;3412;2134;616;552;1906;5809;520;4030;1685;614;2010
Virton;3441;2244;1197;85;1799;1252;305;264;1071;3212;229;2324;803;314;2010
Dinant;9953;6655;3298;284;5569;3337;763;938;2756;9077;876;6808;2358;787;2010
Namur;24297;16004;8293;601;14327;7698;1671;2268;6315;22746;1551;15986;6570;1741;2010
Philippeville;5392;3501;1891;138;3067;1797;390;448;1484;4971;421;3652;1340;400;2010
Nivelles;39425;26593;12832;816;22494;13300;2815;3023;10607;37719;1706;28529;7943;2953;2009
Ath;6729;4346;2383;158;3907;2181;483;557;1788;6057;672;4778;1455;496;2009
Charleroi;23753;15599;8154;739;13856;7537;1621;2466;6131;22271;1482;16061;6006;1686;2009
Mons;14581;9325;5256;364;8575;4723;919;1432;3802;13544;1037;10015;3608;958;2009
Mouscron;4489;2797;1692;135;2677;1362;315;488;1153;3900;589;3419;735;335;2009
Soignies;12299;8000;4299;354;7320;3833;792;1181;3067;11308;991;8394;3079;826;2009
Thuin;11272;7307;3965;293;6461;3768;750;997;3033;10362;910;7908;2588;776;2009
Tournai;11046;7206;3840;283;6361;3640;762;972;3005;9816;1230;8033;2234;779;2009
Huy;8548;5731;2817;214;4987;2837;510;732;2187;7926;622;5848;2146;554;2009
Liège;38674;25627;13047;1064;22294;12485;2831;3919;10241;36410;2264;26237;9385;3052;2009
Verviers;23089;15694;7395;617;13101;7454;1917;2109;6321;21244;1845;16006;5056;2027;2009
Waremme;6182;4140;2042;148;3568;2050;416;518;1662;5718;464;4205;1530;447;2009
Arlon;2688;1619;1069;116;1478;892;202;297;722;2465;223;1936;553;199;2009
Bastogne;4672;3167;1505;156;2493;1538;485;429;1391;4228;444;3103;1080;489;2009
Marche-en-Famenne;5651;3843;1808;201;3140;1859;451;581;1503;5127;524;3792;1395;464;2009
Neufchâteau;6289;4344;1945;161;3457;2095;576;559;1836;5723;566;4010;1683;596;2009
Virton;3429;2246;1183;85;1845;1212;287;289;1015;3175;254;2366;766;297;2009
Dinant;9814;6620;3194;309;5617;3185;703;950;2606;8927;887;6753;2317;744;2009
Namur;23854;15771;8083;591;14373;7362;1528;2310;5989;22237;1617;15807;6393;1654;2009
Philippeville;5302;3473;1829;124;3088;1729;361;435;1410;4859;443;3644;1274;384;2009
Nivelles;38886;26284;12602;811;22619;12812;2644;3070;10185;37026;1860;28357;7722;2807;2008
Ath;6663;4312;2351;160;3934;2103;466;560;1718;5924;739;4776;1400;487;2008
Charleroi;23712;15647;8065;740;14013;7438;1521;2527;5925;22126;1586;16130;5980;1602;2008
Mons;14486;9286;5200;388;8588;4639;871;1442;3668;13374;1112;10024;3556;906;2008
Mouscron;4441;2787;1654;123;2691;1337;290;456;1108;3800;641;3429;702;310;2008
Soignies;12187;7932;4255;341;7347;3732;767;1158;2985;11089;1098;8392;2997;798;2008
Thuin;11172;7285;3887;284;6525;3661;702;981;2910;10179;993;7914;2515;743;2008
Tournai;10960;7180;3780;286;6402;3533;739;996;2896;9638;1322;8053;2144;763;2008
Huy;8475;5677;2798;207;5025;2734;509;732;2115;7810;665;5853;2078;544;2008
Liège;38435;25606;12829;1039;22475;12168;2753;3980;9936;36019;2416;26250;9222;2963;2008
Verviers;23091;15723;7368;644;13325;7247;1875;2173;6139;21022;2069;16190;4917;1984;2008
Waremme;6071;4079;1992;149;3534;1978;410;523;1585;5595;476;4160;1483;428;2008
Arlon;2687;1640;1047;110;1509;855;213;299;702;2442;245;1939;542;206;2008
Bastogne;4667;3183;1484;153;2546;1498;470;427;1344;4198;469;3126;1058;483;2008
Marche-en-Famenne;5622;3844;1778;195;3200;1770;457;570;1464;5065;557;3790;1357;475;2008
Neufchâteau;6299;4366;1933;179;3493;2053;574;567;1811;5691;608;4043;1666;590;2008
Virton;3422;2232;1190;99;1876;1161;286;324;971;3144;278;2371;756;295;2008
Dinant;9755;6636;3119;294;5645;3124;692;943;2532;8840;915;6726;2284;745;2008
Namur;23506;15648;7858;586;14272;7158;1490;2296;5827;21806;1700;15668;6208;1630;2008
Philippeville;5262;3457;1805;129;3069;1703;361;414;1392;4795;467;3631;1246;385;2008
Nivelles;37845;25721;12124;705;22046;12528;2566;2851;10013;35939;1906;27864;7330;2651;2007
Ath;6476;4204;2272;141;3840;2029;466;558;1667;5717;759;4686;1315;475;2007
Charleroi;23003;15197;7806;688;13579;7224;1512;2320;5798;21367;1636;15802;5651;1550;2007
Mons;14610;9397;5213;324;8685;4711;890;1419;3700;13423;1187;10261;3439;910;2007
Mouscron;4406;2769;1637;122;2643;1361;280;419;1117;3753;653;3446;664;296;2007
Soignies;11919;7798;4121;319;7159;3671;770;1098;2957;10784;1135;8361;2789;769;2007
Thuin;11024;7187;3837;242;6538;3558;686;969;2864;9969;1055;7930;2389;705;2007
Tournai;10757;7020;3737;252;6285;3464;756;917;2853;9365;1392;7988;2000;769;2007
Huy;8401;5658;2743;185;4972;2718;526;691;2078;7706;695;5882;1975;544;2007
Liège;37955;25370;12585;859;22208;12079;2809;3720;9902;35460;2495;26088;8930;2937;2007
Verviers;22817;15644;7173;558;13283;7084;1892;2058;6060;20747;2070;16111;4743;1963;2007
Waremme;6063;4060;2003;116;3517;1996;434;505;1589;5566;497;4192;1421;450;2007
Arlon;2639;1652;987;74;1504;838;223;261;691;2388;251;1898;527;214;2007
Bastogne;4677;3195;1482;139;2561;1484;493;420;1352;4166;511;3174;1008;495;2007
Marche-en-Famenne;5548;3809;1739;180;3193;1727;448;539;1430;4979;569;3792;1306;450;2007
Neufchâteau;6314;4399;1915;183;3524;2025;582;580;1773;5676;638;4098;1618;598;2007
Virton;3391;2240;1151;78;1873;1132;308;268;980;3109;282;2330;757;304;2007
Dinant;9803;6668;3135;252;5678;3129;744;920;2582;8841;962;6798;2232;773;2007
Namur;22931;15280;7651;533;13925;6985;1488;2191;5691;21195;1736;15438;5920;1573;2007
Philippeville;5237;3451;1786;115;3036;1700;386;414;1382;4732;505;3616;1223;398;2007
Nivelles;36700;25025;11675;637;21480;12138;2445;2646;9644;34716;1984;27344;6843;2513;2006
Ath;6352;4138;2214;125;3748;2001;478;526;1648;5581;771;4650;1219;483;2006
Charleroi;22450;14861;7589;578;13305;7099;1468;2107;5675;20787;1663;15541;5426;1483;2006
Mons;14380;9245;5135;312;8565;4630;873;1336;3564;13142;1238;10262;3238;880;2006
Mouscron;4388;2764;1624;110;2648;1353;277;397;1108;3712;676;3461;642;285;2006
Soignies;11715;7678;4037;250;7090;3636;739;1026;2885;10544;1171;8369;2606;740;2006
Thuin;10819;7057;3762;246;6414;3464;695;931;2775;9728;1091;7826;2302;691;2006
Tournai;10614;6968;3646;233;6192;3420;769;895;2822;9190;1424;7980;1860;774;2006
Huy;8220;5539;2681;158;4913;2635;514;653;2017;7496;724;5840;1850;530;2006
Liège;37329;24982;12347;756;21948;11771;2854;3490;9688;34743;2586;25841;8553;2935;2006
Verviers;22729;15670;7059;507;13340;6987;1895;1961;6024;20607;2122;16183;4601;1945;2006
Waremme;5888;3937;1951;111;3437;1900;440;469;1507;5367;521;4095;1344;449;2006
Arlon;2589;1624;965;52;1480;830;227;241;687;2343;246;1865;507;217;2006
Bastogne;4662;3194;1468;111;2612;1439;500;406;1336;4130;532;3215;950;497;2006
Marche-en-Famenne;5447;3757;1690;151;3182;1677;437;496;1393;4882;565;3788;1221;438;2006
Neufchâteau;6275;4403;1872;166;3572;1942;595;557;1746;5621;654;4098;1582;595;2006
Virton;3355;2228;1127;71;1864;1111;309;246;949;3055;300;2339;714;302;2006
Dinant;9634;6570;3064;212;5623;3039;760;873;2497;8638;996;6740;2118;776;2006
Namur;22281;14902;7379;461;13545;6815;1460;2060;5479;20560;1721;15221;5547;1513;2006
Philippeville;5137;3402;1735;99;3003;1652;383;385;1369;4621;516;3631;1118;388;2006
Nivelles;36005;24532;11473;621;21461;11632;2291;2710;9122;33919;2086;27106;6510;2389;2005
Ath;6239;4058;2181;121;3732;1916;470;514;1564;5441;798;4599;1158;482;2005
Charleroi;22184;14692;7492;550;13327;6862;1445;2032;5438;20446;1738;15549;5139;1496;2005
Mons;14193;9147;5046;342;8535;4440;876;1375;3424;12894;1299;10293;3013;887;2005
Mouscron;4415;2793;1622;102;2731;1313;269;430;1078;3723;692;3506;622;287;2005
Soignies;11559;7585;3974;256;7066;3496;741;1038;2770;10345;1214;8325;2474;760;2005
Thuin;10657;6954;3703;247;6359;3363;688;920;2655;9512;1145;7828;2122;707;2005
Tournai;10537;6896;3641;236;6192;3354;755;898;2729;9058;1479;8009;1753;775;2005
Huy;8069;5450;2619;138;4911;2512;508;639;1907;7315;754;5802;1735;532;2005
Liège;36956;24772;12184;819;22008;11350;2779;3516;9313;34277;2679;26031;8000;2925;2005
Verviers;22663;15639;7024;542;13387;6864;1870;1998;5841;20481;2182;16171;4516;1976;2005
Waremme;5860;3924;1936;120;3453;1849;438;478;1439;5318;542;4136;1287;437;2005
Arlon;2554;1599;955;68;1455;806;225;240;684;2314;240;1849;485;220;2005
Bastogne;4704;3216;1488;115;2703;1385;501;412;1285;4145;559;3235;966;503;2005
Marche-en-Famenne;5393;3730;1663;157;3225;1583;428;497;1330;4818;575;3786;1159;448;2005
Neufchâteau;6236;4384;1852;180;3601;1866;589;562;1647;5562;674;4093;1540;603;2005
Virton;3322;2198;1124;79;1876;1060;307;255;888;3001;321;2342;681;299;2005
Dinant;9599;6528;3071;241;5675;2950;733;882;2408;8546;1053;6849;1992;758;2005
Namur;21898;14688;7210;457;13457;6578;1406;2015;5222;20103;1795;15116;5272;1510;2005
Philippeville;5098;3375;1723;106;3017;1579;396;410;1318;4570;528;3623;1059;416;2005
Nivelles;35570;24171;11399;562;21572;11206;2230;2720;8794;33300;2270;27088;6179;2303;2004
Ath;6252;4082;2170;124;3734;1904;490;494;1567;5392;860;4665;1080;507;2004
Charleroi;22392;14789;7603;555;13598;6785;1454;2015;5304;20420;1972;15921;5003;1468;2004
Mons;14115;9048;5067;347;8573;4292;903;1360;3282;12738;1377;10344;2867;904;2004
Mouscron;4437;2763;1674;116;2707;1345;269;435;1083;3700;737;3590;565;282;2004
Soignies;11542;7562;3980;265;7124;3394;759;1054;2686;10261;1281;8410;2371;761;2004
Thuin;10673;6940;3733;220;6442;3315;696;893;2638;9404;1269;7936;2041;696;2004
Tournai;10587;6904;3683;212;6250;3311;814;894;2740;9017;1570;8113;1672;802;2004
Huy;8100;5459;2641;155;4989;2428;528;678;1856;7299;801;5850;1702;548;2004
Liège;36919;24680;12239;826;22230;11010;2853;3481;9079;34028;2891;26341;7627;2951;2004
Verviers;22749;15661;7088;572;13565;6716;1896;2026;5680;20464;2285;16330;4429;1990;2004
Waremme;5784;3892;1892;108;3408;1815;453;430;1436;5223;561;4098;1230;456;2004
Arlon;2572;1614;958;74;1483;789;226;248;668;2294;278;1880;471;221;2004
Bastogne;4733;3245;1488;116;2773;1345;499;407;1271;4106;627;3273;969;491;2004
Marche-en-Famenne;5374;3700;1674;139;3289;1513;433;473;1290;4743;631;3817;1110;447;2004
Neufchâteau;6209;4354;1855;180;3622;1810;597;594;1616;5476;733;4139;1470;600;2004
Virton;3349;2223;1126;83;1926;1022;318;272;851;3002;347;2359;685;305;2004
Dinant;9545;6461;3084;237;5715;2842;751;889;2364;8424;1121;6915;1878;752;2004
Namur;21726;14586;7140;473;13478;6373;1402;2029;4973;19831;1895;15242;5017;1467;2004
Philippeville;5127;3401;1726;112;3077;1534;404;407;1281;4566;561;3711;1002;414;2004
Nivelles;34907;23713;11194;535;21301;10917;2154;2601;8504;32500;2407;26906;5777;2224;2003
Ath;6298;4116;2182;135;3786;1875;502;534;1544;5415;883;4725;1071;502;2003
Charleroi;22415;14640;7775;509;13771;6696;1439;1907;5151;20297;2118;16200;4763;1452;2003
Mons;14128;9021;5107;334;8649;4204;941;1353;3226;12694;1434;10547;2674;907;2003
Mouscron;4466;2768;1698;111;2735;1344;276;445;1083;3743;723;3629;557;280;2003
Soignies;11509;7532;3977;244;7193;3301;771;1020;2634;10179;1330;8495;2259;755;2003
Thuin;10673;6906;3767;218;6436;3302;717;876;2634;9349;1324;8071;1901;701;2003
Tournai;10645;6941;3704;223;6295;3289;838;911;2730;9058;1587;8253;1596;796;2003
Huy;8028;5383;2645;148;5000;2328;552;676;1787;7199;829;5868;1602;558;2003
Liège;37115;24720;12395;827;22455;10940;2893;3448;8987;33993;3122;26784;7414;2917;2003
Verviers;22812;15584;7228;550;13774;6594;1894;1998;5620;20337;2475;16664;4190;1958;2003
Waremme;5747;3848;1899;107;3410;1767;463;443;1405;5161;586;4111;1175;461;2003
Arlon;2630;1651;979;57;1539;798;236;225;678;2311;319;1922;480;228;2003
Bastogne;4824;3306;1518;128;2863;1318;515;431;1252;4154;670;3351;972;501;2003
Marche-en-Famenne;5331;3663;1668;125;3279;1471;456;459;1283;4676;655;3822;1048;461;2003
Neufchâteau;6217;4337;1880;178;3655;1771;613;602;1601;5449;768;4229;1386;602;2003
Virton;3409;2257;1152;75;2001;1003;330;261;861;3022;387;2417;673;319;2003
Dinant;9567;6437;3130;240;5748;2779;800;841;2359;8383;1184;7032;1773;762;2003
Namur;21679;14465;7214;448;13475;6345;1411;2038;4887;19620;2059;15435;4792;1452;2003
Philippeville;5132;3375;1757;92;3119;1491;430;413;1268;4511;621;3764;944;424;2003
Nivelles;33075;23495;9580;608;20414;9963;2090;2664;7731;32289;786;25225;5608;2242;2002
Ath;5764;4096;1668;119;3538;1582;525;546;1398;5378;386;4271;1000;538;2002
Charleroi;21025;14644;6381;491;13209;5942;1383;1937;4561;20502;523;14824;4731;1470;2002
Mons;13134;8991;4143;336;8249;3665;884;1379;2820;12692;442;9606;2620;908;2002
Mouscron;4039;2763;1276;103;2519;1149;268;457;931;3744;295;3199;549;291;2002
Soignies;10594;7536;3058;254;6705;2871;764;1025;2340;10154;440;7627;2174;793;2002
Thuin;9871;6956;2915;229;6067;2878;697;908;2305;9463;408;7246;1896;729;2002
Tournai;9621;6916;2705;237;5820;2771;793;913;2355;9021;600;7269;1539;813;2002
Huy;7473;5327;2146;165;4761;2023;524;676;1556;7193;280;5365;1555;553;2002
Liège;35214;24696;10518;823;21771;9859;2761;3371;8115;34273;941;24976;7279;2959;2002
Verviers;21236;15616;5620;525;12999;5835;1877;1953;5158;20458;778;15098;4103;2035;2002
Waremme;5380;3861;1519;109;3279;1541;451;453;1259;5178;202;3760;1153;467;2002
Arlon;2459;1664;795;49;1493;701;216;224;602;2361;98;1733;502;224;2002
Bastogne;4436;3309;1127;125;2654;1160;497;413;1151;4172;264;2969;947;520;2002
Marche-en-Famenne;4917;3634;1283;127;3069;1261;460;448;1158;4663;254;3428;1008;481;2002
Neufchâteau;5786;4352;1434;171;3483;1543;589;616;1435;5465;321;3777;1392;617;2002
Virton;3179;2279;900;71;1914;875;319;253;759;3036;143;2154;690;335;2002
Dinant;8803;6421;2382;236;5373;2427;767;840;2112;8377;426;6283;1719;801;2002
Namur;20218;14329;5889;471;12816;5594;1337;2035;4314;19528;690;14171;4621;1426;2002
Philippeville;4809;3392;1417;108;2980;1308;413;438;1119;4588;221;3445;941;423;2002
Nivelles;32737;23342;9395;640;20495;9545;2057;2785;7300;31921;816;25024;5478;2234;2001
Ath;5802;4129;1673;164;3574;1547;517;596;1394;5408;394;4265;991;546;2001
Charleroi;21311;14879;6432;584;13521;5834;1372;2125;4400;20793;518;15107;4703;1500;2001
Mons;13370;9186;4184;343;8564;3542;921;1497;2737;12942;428;9779;2624;967;2001
Mouscron;4112;2843;1269;132;2568;1134;278;527;919;3810;302;3274;534;303;2001
Soignies;10542;7488;3054;284;6734;2764;760;1118;2275;10112;430;7619;2111;812;2001
Thuin;9953;7036;2917;246;6164;2809;734;949;2230;9527;426;7342;1835;775;2001
Tournai;9651;6972;2679;276;5872;2723;780;990;2248;9026;625;7326;1509;816;2001
Huy;7499;5376;2123;166;4860;1947;526;690;1507;7207;292;5405;1521;573;2001
Liège;35471;24913;10558;835;22298;9585;2753;3622;7757;34513;958;25265;7166;3040;2001
Verviers;21459;15816;5643;608;13242;5740;1869;2143;5042;20615;844;15386;4006;2067;2001
Waremme;5429;3918;1511;125;3399;1467;438;515;1205;5224;205;3842;1116;471;2001
Arlon;2508;1712;796;62;1548;687;211;254;595;2407;101;1766;511;230;2001
Bastogne;4473;3347;1126;140;2702;1123;508;424;1148;4203;270;3008;922;543;2001
Marche-en-Famenne;4923;3634;1289;149;3081;1242;451;495;1138;4655;268;3468;960;495;2001
Neufchâteau;5768;4350;1418;171;3522;1490;585;649;1407;5446;322;3774;1369;624;2001
Virton;3226;2323;903;72;1990;841;323;284;727;3077;149;2225;661;340;2001
Dinant;8829;6427;2402;267;5457;2328;777;935;2056;8392;437;6300;1698;831;2001
Namur;20061;14274;5787;485;12884;5391;1301;2123;4085;19360;701;14141;4488;1431;2001
Philippeville;4791;3393;1398;109;2984;1292;406;456;1079;4558;233;3454;904;433;2001
Nivelles;32681;23348;9333;658;20696;9308;2019;3004;6893;31855;826;25107;5345;2227;2000
Ath;5842;4183;1659;181;3612;1512;537;662;1376;5451;391;4303;969;570;2000
Charleroi;21545;15089;6456;610;13873;5647;1415;2314;4185;21060;485;15439;4548;1558;2000
Mons;13387;9187;4200;375;8659;3438;915;1591;2594;12962;425;9922;2463;1002;2000
Mouscron;4161;2867;1294;146;2615;1121;279;581;907;3848;313;3336;510;315;2000
Soignies;10656;7578;3078;310;6862;2694;790;1182;2208;10237;419;7778;2028;850;2000
Thuin;10008;7092;2916;264;6285;2720;739;1019;2112;9595;413;7427;1789;792;2000
Tournai;9773;7080;2693;291;6021;2672;789;1107;2208;9144;629;7440;1502;831;2000
Huy;7508;5411;2097;178;4942;1859;529;760;1445;7196;312;5464;1464;580;2000
Liège;35978;25212;10766;916;22893;9404;2765;3955;7491;35017;961;25842;7011;3123;2000
Verviers;21676;16009;5667;644;13505;5648;1879;2278;4972;20815;861;15676;3896;2104;2000
Waremme;5407;3913;1494;125;3424;1413;445;533;1180;5196;211;3872;1037;498;2000
Arlon;2555;1754;801;75;1576;690;214;287;595;2455;100;1825;498;232;2000
Bastogne;4515;3401;1114;157;2745;1090;523;471;1148;4233;282;3055;896;564;2000
Marche-en-Famenne;4975;3669;1306;153;3124;1238;460;536;1136;4699;276;3535;928;512;2000
Neufchâteau;5830;4420;1410;177;3624;1448;581;679;1369;5511;319;3844;1356;630;2000
Virton;3260;2365;895;87;2028;815;330;305;726;3103;157;2225;671;364;2000
Dinant;8916;6508;2408;280;5555;2266;815;999;2030;8475;441;6374;1650;892;2000
Namur;20011;14218;5793;561;12949;5244;1257;2288;3903;19316;695;14259;4333;1418;2000
Philippeville;4825;3414;1411;114;3037;1262;412;505;1045;4584;241;3489;890;446;2000
